{
  "亜": "亞",
  "悪": "惡",
  "圧": "壓",
  "囲": "圍",
  "為": "爲",
  "医": "醫",
  "壱": "壹",
  "隠": "隱",
  "栄": "榮",
  "営": "營",
  "衛": "衞",
  "駅": "驛",
  "円": "圓",
  "縁": "緣",
  "塩": "鹽",
  "欧": "歐",
  "殴": "毆",
  "穏": "穩",
  "仮": "假",
  "価": "價",
  "画": "畫",
  "会": "會",
  "壊": "壞",
  "懐": "懷",
  "絵": "繪",
  "拡": "擴",
  "殻": "殼",
  "覚": "覺",
  "学": "學",
  "岳": "嶽",
  "楽": "樂",
  "缶": "罐",
  "巻": "卷",
  "陥": "陷",
  "勧": "勸",
  "観": "觀",
  "関": "關",
  "歓": "歡",
  "巌": "巖",
  "顔": "顏",
  "帰": "歸",
  "気": "氣",
  "亀": "龜",
  "偽": "僞",
  "戯": "戲",
  "犠": "犧",
  "旧": "舊",
  "拠": "據",
  "挙": "舉",
  "虚": "虛",
  "峡": "峽",
  "挟": "挾",
  "狭": "狹",
  "郷": "鄕",
  "響": "響",
  "暁": "曉",
  "区": "區",
  "駆": "驅",
  "茎": "莖",
  "径": "徑",
  "渓": "溪",
  "経": "經",
  "継": "繼",
  "鶏": "鷄",
  "芸": "藝",
  "撃": "擊",
  "欠": "缺",
  "県": "縣",
  "剣": "劍",
  "検": "檢",
  "権": "權",
  "献": "獻",
  "厳": "嚴",
  "広": "廣",
  "鉱": "鑛",
  "効": "效",
  "号": "號",
  "国": "國",
  "砕": "碎",
  "済": "濟",
  "斎": "齋",
  "剤": "劑",
  "雑": "雜",
  "参": "參",
  "桟": "棧",
  "惨": "慘",
  "賛": "贊",
  "残": "殘",
  "蚕": "蠶",
  "児": "兒",
  "辞": "辭",
  "湿": "濕",
  "実": "實",
  "写": "寫",
  "舎": "舍",
  "釈": "釋",
  "寿": "壽",
  "収": "收",
  "従": "從",
  "渋": "澁",
  "獣": "獸",
  "縦": "縱",
  "粛": "肅",
  "処": "處",
  "叙": "敘",
  "将": "將",
  "渉": "涉",
  "焼": "燒",
  "称": "稱",
  "証": "證",
  "乗": "乘",
  "条": "條",
  "状": "狀",
  "畳": "疊",
  "縄": "繩",
  "壌": "壤",
  "嬢": "孃",
  "譲": "讓",
  "醸": "釀",
  "触": "觸",
  "寝": "寢",
  "慎": "愼",
  "図": "圖",
  "粋": "粹",
  "酔": "醉",
  "随": "隨",
  "髄": "髓",
  "数": "數",
  "枢": "樞",
  "瀬": "瀨",
  "声": "聲",
  "斉": "齊",
  "静": "靜",
  "窃": "竊",
  "摂": "攝",
  "専": "專",
  "戦": "戰",
  "浅": "淺",
  "践": "踐",
  "銭": "錢",
  "禅": "禪",
  "双": "雙",
  "壮": "壯",
  "争": "爭",
  "荘": "莊",
  "装": "裝",
  "騒": "騷",
  "増": "增",
  "即": "卽",
  "属": "屬",
  "続": "續",
  "堕": "墮",
  "対": "對",
  "体": "體",
  "帯": "帶",
  "滞": "滯",
  "台": "臺",
  "滝": "瀧",
  "択": "擇",
  "沢": "澤",
  "単": "單",
  "担": "擔",
  "胆": "膽",
  "団": "團",
  "弾": "彈",
  "断": "斷",
  "遅": "遲",
  "痴": "癡",
  "昼": "晝",
  "虫": "蟲",
  "鋳": "鑄",
  "庁": "廳",
  "徴": "徵",
  "聴": "聽",
  "勅": "敕",
  "鎮": "鎭",
  "逓": "遞",
  "鉄": "鐵",
  "転": "轉",
  "点": "點",
  "伝": "傳",
  "党": "黨",
  "当": "當",
  "灯": "燈",
  "盗": "盜",
  "稲": "稻",
  "闘": "鬪",
  "徳": "德",
  "独": "獨",
  "読": "讀",
  "届": "屆",
  "弐": "貳",
  "悩": "惱",
  "脳": "腦",
  "覇": "霸",
  "廃": "廢",
  "拝": "拜",
  "杯": "盃",
  "売": "賣",
  "麦": "麥",
  "発": "發",
  "髪": "髮",
  "抜": "拔",
  "反": "反",
  "晩": "晚",
  "蛮": "蠻",
  "秘": "祕",
  "浜": "濱",
  "歩": "步",
  "宝": "寶",
  "豊": "豐",
  "没": "沒",
  "翻": "飜",
  "毎": "每",
  "満": "滿",
  "万": "萬",
  "黙": "默",
  "弥": "彌",
  "訳": "譯",
  "薬": "藥",
  "予": "豫",
  "余": "餘",
  "誉": "譽",
  "与": "與",
  "様": "樣",
  "来": "來",
  "頼": "賴",
  "覧": "覽",
  "竜": "龍",
  "猟": "獵",
  "涙": "淚",
  "塁": "壘",
  "励": "勵",
  "戻": "戾",
  "礼": "禮",
  "霊": "靈",
  "齢": "齡",
  "暦": "曆",
  "歴": "歷",
  "錬": "鍊",
  "炉": "爐",
  "労": "勞",
  "楼": "樓",
  "録": "錄",
  "湾": "灣",
  "脇": "脅",
  "枠": "枠",
  "携": "攜",
  "蛍": "螢",
  "桜": "櫻",
  "応": "應",
  "払": "拂",
  "仏": "佛",
  "鑑": "鑑",
  "恋": "戀",
  "変": "變",
  "潜": "潛",
  "繊": "纖",
  "穣": "穰",
  "歯": "齒",
  "喝": "喝",
  "渇": "渴",
  "褐": "褐",
  "勤": "勤",
  "謹": "謹",
  "研": "硏",
  "戸": "戶",
  "穀": "穀",
  "殺": "殺",
  "社": "社",
  "者": "者",
  "煮": "煮",
  "臭": "臭",
  "署": "署",
  "緒": "緒",
  "諸": "諸",
  "節": "節",
  "憎": "憎",
  "第": "第",
  "題": "題",
  "著": "著",
  "懲": "懲",
  "陳": "陳",
  "墜": "墜",
  "塚": "塚",
  "漬": "漬",
  "坪": "坪",
  "低": "低",
  "呈": "呈",
  "廷": "廷",
  "邸": "邸",
  "貞": "貞",
  "訂": "訂",
  "買": "買",
  "罰": "罰",
  "働": "動",
  "込": "込",
  "畑": "畑",
  "峠": "峠",
  "辻": "辻"
}